NO assets/rock.xpm
SO assets/window.xpm
WE assets/brick.xpm
EA assets/wood.xpm
F 255,0,0
C 0,0,100

11111111
10000001
10000001
10100001
10000001
10N0111
10001
11111
