NO assets/rock.xpm
SO assets/window.xpm
WE assets/brick.xpm
EA assets/wood.xpm
F 255,0,0
C 0,0,100

11111
10001
10N01
10001
11111
