NO assets/rock.xpm
SO assets/window.xpm
WE assets/brick.xpm
EA assets/wood.xpm
F 255,0,0
C 0,0,100

11111111111111111111111111111111111111111111
1110000000100000100000000000000000000000000011
100000000010011010000000000000000000000000111
1000000000100000000000000001000000000000001
10000000001000000000000000000000000000000011
11000000000000000000000000000000000000000001
1100000000100000000000000000000000000000001
11000000000000000000000000000000000000000001
11000000000000000000000001000000000000000001
1000000000000000N00000000000000000000000001
1111111111111111111111111111111111111111111
